// El fichero lexico.txt define los componentes léxicos del lenguaje,
// definidos por parejas de componente léxicos y lexemas
// Operadores relacionales y de asignación

greater_than	> 
greater_equals	>=
less_than	<
less_equals	<=
equals	==
not_equals	!=
assignment	=

// Operadores aritméticos

add	+
subtract	-
multiply	*
divide		/
remainder	%

// Operadores lógicos

and	&&
or	||
not	!
// Delimitadores

dot	.
comma	,
semicolon	;
open_parenthesis	(
closed_parenthesis	)
open_square_bracket	[
closed_square_bracket	]
open_bracket	{
closed_bracket	}
end_program		#

// Palabras reservadas

boolean	boolean
break	break
do	do
else	else
false	false
float	float
for	for
if	if
int	int
while	while
true	true
void	void
main	main
print	print